555555555555
544444444445
541444244345
543444242445
544443444445
555555555555