555555555
554344455
554425455
554123455
555555555
